..........................
..........................
..........................
................#####.....
................#####.....
................#####.....
..........................
..........................
..........................
..........................
.....#####......#####.....
........##......##........
........##......##........
..........................
..........................